{
  "tileset" : "chemin.png",
  "terrain" : [
    [2, 2, 2, 2, 2, 2, 11, 12, 13,  2,  2,  2,  2,  2,  2, 2, 2, 2, 2, 2, 2, 2, 2, 2, 2, 2, 2, 11, 12, 13,  2,  2,  2,  2,  2,  2],
    [2, 2, 2, 2, 2, 2, 11, 12, 13,  2,  21,  22,  23,  24,  25, 2, 2, 2, 2, 2, 2, 2, 2, 2, 2, 2, 2, 11, 12, 13,  2,  2,  2,  2,  2,  2],
    [2, 2, 2, 2, 2, 2, 11, 12, 13,  2,  26,  27,  28,  29,  30, 2, 2, 2, 2, 2, 2, 2, 2, 2, 2, 2, 2, 11, 12, 13,  2,  2,  2,  2,  2,  2],
    [2, 2, 2, 2, 2, 2, 11, 12, 13,  2,  31,  32,  33,  34,  35, 2, 2, 2, 2, 2, 2, 2, 2, 2, 2, 2, 2, 11, 12, 13,  2,  2,  2,  2,  2,  2],
    [2, 2, 2, 2, 2, 2, 11, 12, 13,  2,  36,  37,  38,  39,  40, 2, 2, 2, 2, 2, 2, 2, 2, 2, 2, 2, 2, 11, 12, 13,  2,  2,  2,  2,  2,  2],
    [2, 2, 2, 2, 2, 2, 11, 12, 13,  2,  41,  42,  43,  44,  45, 2, 2, 2, 2, 2, 2, 2, 2, 2, 2, 2, 2, 11, 12, 13,  2,  2,  2,  2,  2,  2],
    [2, 2, 2, 2, 2, 2, 11, 12,  9,  4,  4,  4,  4,  4,  4, 4, 4, 4, 4, 4, 4, 4, 4, 4, 4, 4, 4, 12,12, 13,  2,  2,  2,  2,  2,  2],
    [2, 2, 2, 2, 2, 2, 11, 12, 12, 12, 12, 12, 12, 12, 12,12,12,12,12,12,12,12,12,12,12,12,12, 12,12, 13,  2,  2,  2,  2,  2,  2],
    [2, 2, 2, 2, 2, 2, 11, 12, 14, 14, 14, 14, 14, 14, 14,14,14,14,14,14,14,14,14,14,14,14,14, 12,12, 13,  2,  2,  2,  2,  2,  2],
    [2, 2, 2, 2, 2, 2, 11, 12, 13,  2,  2,  2,  2,  2,  2, 2, 2, 2, 2, 2, 2, 2, 2, 2, 2, 2, 2, 11, 12, 13,  2,  2,  2,  2,  2,  2],
    [2, 2, 2, 2, 2, 2, 11, 12, 13,  2,  2,  2,  2,  2,  2, 2, 2, 2, 2, 2, 2, 2, 2, 2, 2, 2, 2, 11, 12, 13,  2,  2,  2,  2,  2,  2],
    [2, 2, 2, 2, 2, 2, 11, 12, 13,  2,  2,  2,  2,  2,  2, 2, 2, 2, 2, 2, 2, 2, 2, 2, 2, 2, 2, 11, 12, 13,  2,  2,  2,  2,  2,  2],
    [2, 2, 2, 2, 2, 2, 11, 12, 13,  2,  2,  2,  2,  2,  2, 2, 2, 2, 2, 2, 2, 2, 2, 2, 2, 2, 2, 11, 12, 13,  2,  2,  2,  2,  2,  2],
    [2, 2, 2, 2, 2, 2, 11, 12, 13,  2,  2,  2,  2,  2,  2, 2, 2, 2, 2, 2, 2, 2, 2, 2, 2, 2, 2, 11, 12, 13,  2,  2,  2,  2,  2,  2],
    [2, 2, 2, 2, 2, 2, 11, 12, 13,  2,  2,  2,  2,  2,  2, 2, 2, 2, 2, 2, 2, 2, 2, 2, 2, 2, 2, 11, 12, 13,  2,  2,  2,  2,  2,  2],
    [2, 2, 2, 2, 2, 2, 11, 12, 13,  2,  2,  2,  2,  2,  2, 2, 2, 2, 2, 2, 2, 2, 2, 2, 2, 2, 2, 11, 12, 13,  2,  2,  2,  2,  2,  2],
    [2, 2, 2, 2, 2, 2, 11, 12, 13,  2,  2,  2,  2,  2,  2, 2, 2, 2, 2, 2, 2, 2, 2, 2, 2, 2, 2, 11, 12, 13,  2,  2,  2,  2,  2,  2],
    [2, 2, 2, 2, 2, 2, 11, 12, 13,  2,  2,  2,  2,  2,  2, 2, 2, 2, 2, 2, 2, 2, 2, 2, 2, 2, 2, 11, 12, 13,  2,  2,  2,  2,  2,  2],
    [2, 2, 2, 2, 2, 2, 11, 12, 13,  2,  2,  2,  2,  2,  2, 2, 2, 2, 2, 2, 2, 2, 2, 2, 2, 2, 2, 11, 12, 13,  2,  2,  2,  2,  2,  2],
    [2, 2, 2, 2, 2, 2, 11, 12, 13,  2,  2,  2,  2,  2,  2, 2, 2, 2, 2, 2, 2, 2, 2, 2, 2, 2, 2, 11, 12, 13,  2,  2,  2,  2,  2,  2],
    [2, 2, 2, 2, 2, 2, 11, 12, 13,  2,  2,  2,  2,  2,  2, 2, 2, 2, 2, 2, 2, 2, 2, 2, 2, 2, 2, 11, 12, 13,  2,  2,  2,  2,  2,  2],
    [2, 2, 2, 2, 2, 2, 11, 12, 13,  2,  2,  2,  2,  2,  2, 2, 2, 2, 2, 2, 2, 2, 2, 2, 2, 2, 2, 11, 12, 13,  2,  2,  2,  2,  2,  2],
    [2, 2, 2, 2, 2, 2, 11, 12, 13,  2,  2,  2,  2,  2,  2, 2, 2, 2, 2, 2, 2, 2, 2, 2, 2, 2, 2, 11, 12, 13,  2,  2,  2,  2,  2,  2],
    [2, 2, 2, 2, 2, 2, 11, 12, 13,  2,  2,  2,  2,  2,  2, 2, 2, 2, 2, 2, 2, 2, 2, 2, 2, 2, 2, 11, 12, 13,  2,  2,  2,  2,  2,  2],
    [2, 2, 2, 2, 2, 2, 11, 12, 13,  2,  2,  2,  2,  2,  2, 2, 2, 2, 2, 2, 2, 2, 2, 2, 2, 2, 2, 11, 12, 13,  2,  2,  2,  2,  2,  2],
    [2, 2, 2, 2, 2, 2, 11, 12, 13,  2,  2,  2,  2,  2,  2, 2, 2, 2, 2, 2, 2, 2, 2, 2, 2, 2, 2, 11, 12, 13,  2,  2,  2,  2,  2,  2],
    [2, 2, 2, 2, 2, 2, 11, 12, 13,  2,  2,  2,  2,  2,  2, 2, 2, 2, 2, 2, 2, 2, 2, 2, 2, 2, 2, 11, 12, 13,  2,  2,  2,  2,  2,  2],
    [2, 2, 2, 2, 2, 2, 11, 12, 13,  2,  2,  2,  2,  2,  2, 2, 2, 2, 2, 2, 2, 2, 2, 2, 2, 2, 2, 11, 12, 13,  2,  2,  2,  2,  2,  2],
    [2, 2, 2, 2, 2, 2, 11, 12, 13,  2,  2,  2,  2,  2,  2, 2, 2, 2, 2, 2, 2, 2, 2, 2, 2, 2, 2, 11, 12, 13,  2,  2,  2,  2,  2,  2],
    [2, 2, 2, 2, 2, 2, 11, 12, 13,  2,  2,  2,  2,  2,  2, 2, 2, 2, 2, 2, 2, 2, 2, 2, 2, 2, 2, 11, 12, 13,  2,  2,  2,  2,  2,  2],
    [2, 2, 2, 2, 2, 2, 11, 12, 13,  2,  2,  2,  2,  2,  2, 2, 2, 2, 2, 2, 2, 2, 2, 2, 2, 2, 2, 11, 12, 13,  2,  2,  2,  2,  2,  2],
    [2, 2, 2, 2, 2, 2, 11, 12, 13,  2,  2,  2,  2,  2,  2, 2, 2, 2, 2, 2, 2, 2, 2, 2, 2, 2, 2, 11, 12, 13,  2,  2,  2,  2,  2,  2],
    [2, 2, 2, 2, 2, 2, 11, 12, 13,  2,  2,  2,  2,  2,  2, 2, 2, 2, 2, 2, 2, 2, 2, 2, 2, 2, 2, 11, 12, 13,  2,  2,  2,  2,  2,  2],
    [2, 2, 2, 2, 2, 2, 11, 12, 13,  2,  2,  2,  2,  2,  2, 2, 2, 2, 2, 2, 2, 2, 2, 2, 2, 2, 2, 11, 12, 13,  2,  2,  2,  2,  2,  2],
    [2, 2, 2, 2, 2, 2, 11, 12, 13,  2,  2,  2,  2,  2,  2, 2, 2, 2, 2, 2, 2, 2, 2, 2, 2, 2, 2, 11, 12, 13,  2,  2,  2,  2,  2,  2],
    [2, 2, 2, 2, 2, 2, 11, 12, 13,  2,  2,  2,  2,  2,  2, 2, 2, 2, 2, 2, 2, 2, 2, 2, 2, 2, 2, 11, 12, 13,  2,  2,  2,  2,  2,  2]
  ]
}